################
#              #
#              #
#              #
#              #
#              #
#      S       #
#              #
#              #
#              #
#              #
#             E#
################