################
#              #
#              #
#              #
#              #
#              #
#      S       #
#              #
#              #
#              #
#              #
#           T E#
################