################
#              #
#              #
#        0     #
#              #
#              #
#      S       #
#              #
#              #
#              #
#              #
#       1   T E#
################